25
0 0 4 2 0 1 1 0
0 1 5 4 0 0 0 2 1 1 1 0
0 2 6 4 0 1 0 3 1 2 1 1
0 3 5 4 0 2 0 4 1 3 1 2
0 4 4 3 0 3 1 4 1 3
1 0 5 5 1 1 0 0 0 1 2 0 2 1
1 1 7 6 1 0 1 2 0 1 0 2 2 1 2 2
1 2 9 6 1 1 1 3 0 2 0 3 2 2 2 3
1 3 7 6 1 2 1 4 0 3 0 4 2 3 2 4
1 4 5 3 1 3 0 4 2 4
2 0 6 3 2 1 1 0 3 0
2 1 9 6 2 0 2 2 1 1 1 0 3 1 3 0
2 2 12 6 2 1 2 3 1 2 1 1 3 2 3 1
2 3 9 6 2 2 2 4 1 3 1 2 3 3 3 2
2 4 6 5 2 3 1 4 1 3 3 4 3 3
3 0 5 5 3 1 2 0 2 1 4 0 4 1
3 1 7 6 3 0 3 2 2 1 2 2 4 1 4 2
3 2 9 6 3 1 3 3 2 2 2 3 4 2 4 3
3 3 7 6 3 2 3 4 2 3 2 4 4 3 4 4
3 4 5 3 3 3 2 4 4 4
4 0 4 2 4 1 3 0
4 1 5 4 4 0 4 2 3 1 3 0
4 2 6 4 4 1 4 3 3 2 3 1
4 3 5 4 4 2 4 4 3 3 3 2
4 4 4 3 4 3 3 4 3 3
0 0
0 4
4 0
4 4
