81
0 0 14 2 1 0 0 1 
0 1 7 4 1 0 1 1 0 2 0 0 
0 2 12 2 0 1 1 1 
0 3 12 1 0 4 
0 4 7 3 0 3 1 4 0 5 
0 5 9 2 1 4 0 4 
0 6 8 3 1 6 0 7 1 5 
0 7 6 3 0 8 0 6 1 7 
0 8 6 2 1 8 0 7 
1 0 8 4 0 1 2 0 0 0 2 1 
1 1 10 4 0 2 0 1 1 2 2 2 
1 2 14 3 1 3 2 3 1 1 
1 3 14 3 1 2 2 4 1 4 
1 4 7 5 2 4 2 5 1 3 0 5 0 4 
1 5 12 3 1 6 0 6 2 5 
1 6 14 4 2 6 2 7 0 6 1 5 
1 7 10 3 0 7 2 7 2 8 
1 8 6 1 0 8 
2 0 10 2 3 0 1 0 
2 1 14 2 1 0 2 2 
2 2 9 3 1 1 2 1 3 1 
2 3 14 3 3 3 2 4 1 2 
2 4 5 4 1 3 3 3 2 3 1 4 
2 5 11 4 3 4 1 4 1 5 3 5 
2 6 5 3 3 6 1 6 2 7 
2 7 6 3 1 6 1 7 2 6 
2 8 14 3 3 8 3 7 1 7 
3 0 10 2 4 0 2 0 
3 1 8 3 4 1 2 2 4 2 
3 2 11 1 3 3 
3 3 8 4 3 2 2 4 2 3 3 4 
3 4 12 3 2 5 4 5 3 3 
3 5 9 2 3 6 2 5 
3 6 9 3 4 7 3 5 2 6 
3 7 6 2 2 8 4 7 
3 8 7 2 4 8 2 8 
4 0 9 3 3 0 4 1 5 0 
4 1 5 4 5 1 5 0 4 0 3 1 
4 2 9 4 5 2 3 1 5 1 4 3 
4 3 14 3 4 4 4 2 5 2 
4 4 14 4 5 4 5 3 4 3 4 5 
4 5 14 4 4 6 5 4 4 4 3 4 
4 6 9 4 5 5 5 6 4 5 4 7 
4 7 5 4 3 7 4 6 3 6 4 8 
4 8 9 3 5 7 3 8 4 7 
5 0 7 3 4 1 6 1 4 0 
5 1 6 3 4 1 4 2 5 2 
5 2 9 6 4 3 5 3 6 3 4 2 5 1 6 2 
5 3 9 4 4 4 6 3 5 4 5 2 
5 4 12 5 4 5 6 5 5 5 4 4 5 3 
5 5 8 4 6 5 6 6 4 6 5 4 
5 6 11 1 4 6 
5 7 8 2 6 7 4 8 
5 8 10 0 
6 0 14 2 7 0 6 1
6 1 6 3 6 2 5 0 6 0
6 2 5 3 6 1 5 2 6 3 
6 3 11 5 6 2 6 4 5 3 5 2 7 3 
6 4 5 3 6 3 6 5 7 3 
6 5 14 5 7 4 6 4 5 5 5 4 7 5 
6 6 9 3 5 5 7 6 7 5 
6 7 14 3 7 6 7 7 5 7 
6 8 10 0 
7 0 6 2 6 0 8 0 
7 1 10 0 
7 2 14 2 8 2 8 3 
7 3 12 5 7 4 8 4 8 3 6 4 6 3 
7 4 7 3 7 3 6 5 7 5 
7 5 14 4 6 5 6 6 8 6 7 4 
7 6 14 5 8 7 7 7 6 7 6 6 8 6 
7 7 10 4 8 8 6 7 7 6 7 8 
7 8 8 1 7 7 
8 0 6 1 7 0 
8 1 6 1 8 2 
8 2 8 2 8 1 7 2 
8 3 9 2 7 2 7 3 
8 4 7 1 7 3 
8 5 12 0 
8 6 12 2 7 6 7 5 
8 7 7 2 7 6 8 8 
8 8 14 2 7 7 8 7 
0 0
0 8
8 0
8 8
