81
0 0 11 2 1 0 0 1 
0 1 14 2 0 0 1 1 
0 2 9 2 0 3 1 1 
0 3 5 2 0 2 1 2 
0 4 14 3 1 3 0 5 1 4 
0 5 8 1 0 4 
0 6 9 1 1 6 
0 7 6 2 1 7 0 8 
0 8 14 3 0 7 1 8 1 7 
1 0 6 3 0 0 2 1 2 0 
1 1 9 2 0 1 0 2 
1 2 9 3 2 2 2 3 0 3 
1 3 9 1 0 4 
1 4 7 2 1 5 0 4 
1 5 10 1 1 4 
1 6 8 3 1 7 2 6 0 6 
1 7 10 3 0 8 0 7 1 6 
1 8 12 2 2 8 0 8 
2 0 14 3 3 0 2 1 1 0 
2 1 13 5 3 0 2 0 2 2 1 0 3 1 
2 2 14 3 3 1 2 1 1 2 
2 3 12 4 3 3 3 2 1 2 2 4 
2 4 10 4 2 5 2 3 3 3 3 4 
2 5 13 2 3 5 2 4 
2 6 11 2 2 7 1 6 
2 7 9 3 3 7 2 6 3 6 
2 8 10 3 1 8 3 8 3 7 
3 0 13 3 2 0 3 1 2 1 
3 1 11 5 4 2 3 0 2 1 4 1 2 2 
3 2 12 2 4 3 2 3 
3 3 5 4 3 4 4 3 2 3 2 4 
3 4 13 4 3 3 3 5 2 4 4 5 
3 5 5 2 3 4 2 5 
3 6 6 4 4 6 4 7 3 7 2 7 
3 7 5 6 3 6 4 8 2 8 3 8 4 7 2 7 
3 8 12 2 2 8 3 7 
4 0 13 1 5 0 
4 1 7 2 4 2 3 1 
4 2 6 2 4 1 3 1 
4 3 9 2 3 2 3 3 
4 4 12 1 4 5 
4 5 9 3 4 6 3 4 4 4 
4 6 6 3 3 6 5 5 4 5 
4 7 7 3 3 7 5 6 3 6 
4 8 13 3 5 7 3 7 5 8 
5 0 12 4 5 1 4 0 6 1 6 0 
5 1 5 4 5 2 5 0 6 1 6 2 
5 2 6 2 5 1 6 2 
5 3 5 1 6 3 
5 4 13 2 5 5 6 4 
5 5 5 5 4 6 5 6 6 6 6 5 5 4 
5 6 12 5 4 7 6 7 6 6 5 7 5 5 
5 7 11 3 6 7 5 6 4 8 
5 8 13 2 4 8 6 8 
6 0 10 2 5 0 6 1 
6 1 9 6 5 0 6 0 5 1 6 2 7 0 7 1 
6 2 11 4 5 1 7 1 5 2 6 1 
6 3 13 3 7 3 5 3 6 4 
6 4 10 4 5 4 7 4 6 3 6 5 
6 5 12 4 7 5 6 4 6 6 5 5 
6 6 14 5 5 6 7 6 6 5 6 7 5 5 
6 7 13 5 7 7 7 6 5 7 5 6 6 6 
6 8 14 3 7 7 5 8 7 8 
7 0 12 2 7 1 6 1 
7 1 10 5 6 1 7 0 6 2 8 1 7 2 
7 2 8 1 7 1 
7 3 10 2 8 4 6 3 
7 4 7 3 7 5 8 5 6 4 
7 5 9 3 7 6 6 5 7 4 
7 6 9 4 6 6 7 5 7 7 6 7 
7 7 9 5 7 8 6 8 8 7 6 7 7 6 
7 8 6 3 7 7 8 8 6 8 
8 0 14 1 8 1 
8 1 6 3 8 0 7 1 8 2 
8 2 9 2 8 3 8 1 
8 3 8 2 8 2 8 4 
8 4 14 2 7 3 8 3 
8 5 5 2 7 4 8 6 
8 6 9 1 8 5 
8 7 14 2 8 8 7 7 
8 8 11 2 8 7 7 8 
0 0
0 8
8 0
8 8
