81
0 0 10 1 0 1 
0 1 6 3 0 0 1 0 0 2 
0 2 8 3 0 1 1 2 0 3 
0 3 6 2 1 2 0 2 
0 4 6 0 
0 5 8 1 0 6 
0 6 8 3 1 5 1 6 0 5 
0 7 11 0 
0 8 9 1 1 7 
1 0 6 2 2 1 0 1 
1 1 6 2 2 1 1 2 
1 2 6 3 0 2 0 3 1 1 
1 3 7 1 2 3 
1 4 9 2 2 5 2 4 
1 5 8 3 0 6 1 6 2 6 
1 6 9 4 0 6 1 5 1 7 2 7 
1 7 12 3 0 8 1 6 2 7 
1 8 10 1 2 8 
2 0 12 1 2 1 
2 1 11 5 1 1 2 2 2 0 1 0 3 1 
2 2 7 1 2 1 
2 3 14 2 1 3 2 4 
2 4 14 3 2 3 1 4 3 3 
2 5 14 3 2 6 1 4 3 4 
2 6 12 3 3 5 1 5 2 5 
2 7 12 3 1 7 3 6 1 6 
2 8 8 2 1 8 3 8 
3 0 9 1 3 1 
3 1 5 4 2 1 3 2 3 0 4 1 
3 2 8 3 4 3 3 3 3 1 
3 3 13 4 3 4 2 4 4 3 3 2 
3 4 7 2 2 5 3 3 
3 5 8 3 2 6 4 6 4 5 
3 6 5 3 2 7 3 7 4 7 
3 7 12 3 3 8 3 6 4 7 
3 8 11 3 2 8 3 7 4 8 
4 0 10 1 5 0 
4 1 13 3 5 0 3 1 4 2 
4 2 7 3 5 2 4 3 4 1 
4 3 11 4 3 2 3 3 4 2 4 4 
4 4 12 2 5 4 4 3 
4 5 11 2 4 6 3 5 
4 6 7 5 3 5 4 5 4 7 5 6 5 5 
4 7 13 3 4 6 3 6 3 7 
4 8 10 2 3 8 5 8 
5 0 11 3 5 1 4 1 4 0 
5 1 12 1 5 0 
5 2 5 1 4 2 
5 3 8 1 6 3 
5 4 7 2 4 4 6 4 
5 5 13 3 6 5 4 6 5 6 
5 6 8 3 5 5 6 7 4 6 
5 7 5 2 5 8 6 8 
5 8 9 3 5 7 4 8 6 8 
6 0 8 1 7 0 
6 1 12 0 
6 2 12 0 
6 3 14 2 5 3 6 4 
6 4 14 4 7 3 7 4 6 3 5 4 
6 5 14 2 7 4 5 5 
6 6 7 1 7 6 
6 7 11 1 5 6 
6 8 12 3 7 8 5 7 5 8 
7 0 10 2 8 1 6 0 
7 1 12 3 7 2 8 1 8 2 
7 2 9 2 7 3 7 1 
7 3 8 4 7 2 8 3 8 4 6 4 
7 4 9 5 6 5 6 4 8 5 7 5 8 4 
7 5 7 2 7 4 8 5 
7 6 6 4 8 7 7 7 8 6 6 6 
7 7 6 3 8 8 7 8 7 6 
7 8 6 3 6 8 8 8 7 7 
8 0 9 1 8 1 
8 1 11 4 8 0 8 2 7 1 7 0 
8 2 8 3 8 1 7 1 8 3 
8 3 8 2 8 2 7 3 
8 4 6 2 7 4 7 3 
8 5 6 2 7 4 7 5 
8 6 8 2 7 6 8 7 
8 7 6 3 8 6 8 8 7 6 
8 8 10 3 8 7 7 7 7 8 
0 0
0 8
8 0
8 8
