81
0 0 13 2 0 1 1 0 
0 1 12 3 0 0 1 1 0 2 
0 2 11 2 0 1 0 3 
0 3 9 2 0 2 1 3 
0 4 8 1 0 5 
0 5 11 2 0 4 0 6 
0 6 14 2 1 5 0 5 
0 7 10 1 0 8 
0 8 9 2 1 8 0 7 
1 0 5 2 2 0 0 0 
1 1 8 3 1 2 0 1 2 2 
1 2 6 4 1 3 2 3 1 1 2 2 
1 3 8 4 2 3 0 3 2 4 1 2 
1 4 9 2 2 5 2 4 
1 5 13 2 0 6 2 5 
1 6 12 1 1 7 
1 7 6 3 1 8 2 7 1 6 
1 8 8 3 2 8 1 7 0 8 
2 0 12 2 3 0 1 0 
2 1 14 2 3 0 2 2 
2 2 9 5 2 3 1 2 3 2 2 1 1 1 
2 3 6 6 2 2 1 3 2 4 3 3 3 2 1 2 
2 4 7 4 3 4 1 4 2 3 1 3 
2 5 14 5 1 4 3 5 3 4 1 5 2 6 
2 6 7 4 2 5 3 5 2 7 3 6 
2 7 6 5 2 8 2 6 3 7 1 7 3 6 
2 8 9 3 1 8 3 7 2 7 
3 0 9 4 2 1 2 0 3 1 4 1 
3 1 10 4 3 2 4 1 4 2 3 0 
3 2 9 3 2 2 3 1 2 3 
3 3 11 3 4 3 4 4 2 3 
3 4 6 4 3 5 2 5 4 5 2 4 
3 5 8 4 3 4 2 6 4 5 2 5 
3 6 12 2 2 6 2 7 
3 7 14 5 3 8 2 7 4 7 2 8 4 8 
3 8 7 1 3 7 
4 0 5 1 4 1 
4 1 8 4 4 2 3 0 3 1 4 0 
4 2 10 5 5 1 4 1 5 2 4 3 3 1 
4 3 14 3 3 3 5 3 4 2 
4 4 5 3 3 3 5 3 4 5 
4 5 14 5 5 4 3 5 4 4 3 4 5 5 
4 6 10 0 
4 7 8 2 3 7 5 7 
4 8 5 2 3 7 5 7 
5 0 7 3 6 1 6 0 5 1 
5 1 14 4 4 2 5 2 5 0 6 1 
5 2 12 5 6 3 5 3 4 2 6 2 5 1 
5 3 8 5 5 2 6 3 4 3 5 4 4 4 
5 4 6 3 5 3 4 5 5 5 
5 5 11 2 4 5 5 4 
5 6 9 1 6 6 
5 7 10 3 5 8 4 8 4 7 
5 8 9 2 6 8 5 7 
6 0 9 2 7 0 5 0 
6 1 6 5 7 1 6 2 7 0 5 0 5 1 
6 2 7 5 5 2 6 1 6 3 7 1 7 2 
6 3 14 5 7 3 5 2 6 4 5 3 6 2 
6 4 7 3 6 3 6 5 7 4 
6 5 6 2 6 4 7 4 
6 6 9 2 5 6 7 5 
6 7 14 1 7 7 
6 8 12 2 7 8 5 8 
7 0 8 4 8 1 8 0 6 0 6 1 
7 1 6 5 8 2 7 2 8 1 6 2 6 1 
7 2 12 4 6 2 8 3 7 1 7 3 
7 3 13 5 7 4 8 3 8 4 7 2 6 3 
7 4 9 6 8 4 7 3 6 5 6 4 7 5 8 5 
7 5 8 4 7 4 7 6 6 6 8 5 
7 6 6 2 7 5 8 6 
7 7 8 1 6 7 
7 8 5 2 8 8 6 8 
8 0 9 2 8 1 7 0 
8 1 10 3 7 1 7 0 8 0 
8 2 14 1 7 1 
8 3 11 3 8 4 7 2 7 3 
8 4 8 3 8 3 7 3 7 4 
8 5 9 2 7 4 7 5 
8 6 11 1 7 6 
8 7 12 1 8 8 
8 8 13 2 7 8 8 7 
0 0
0 8
8 0
8 8
